0 0 0 0 1 0 0 0 0 0 0 0 0 0 0 0 0 0 0 0 0 
0 0 0 0 1 0 0 4 0 0 0 0 6 0 0 0 0 0 0 0 0 
0 0 0 0 1 0 1 1 1 0 0 5 5 5 0 0 0 0 0 0 0 
3 5 0 8 1 0 0 0 0 0 0 6 0 6 0 0 1 1 1 0 0 
3 1 1 1 1 0 0 0 0 0 9 0 0 0 0 0 0 0 0 1 0 
3 2 0 3 1 1 1 1 1 1 1 0 1 1 1 0 0 5 0 0 0 
1 1 1 3 1 0 0 0 0 0 0 0 0 0 0 0 6 6 6 0 0 
3 0 2 3 1 0 0 0 0 0 0 0 0 0 0 0 5 0 5 0 1 
3 1 1 1 1 0 0 0 0 0 0 0 0 0 0 0 0 0 0 0 1 
3 0 0 0 0 0 0 0 1 0 0 1 1 1 1 1 1 0 0 1 1 
3 0 0 0 0 0 0 0 1 0 0 0 0 0 1 0 0 0 0 0 0 
3 0 0 0 0 0 0 0 1 5 0 0 0 0 1 0 0 0 0 0 6 
3 0 0 0 0 0 0 0 0 1 1 1 0 0 1 0 4 0 0 0 6 
3 * 0 0 0 0 0 0 0 0 0 0 0 0 0 0 0 0 0 0 0 
1 1 1 0 0 9 0 1 0 0 0 0 0 0 0 0 1 0 0 0 1 
1 1 1 1 1 1 1 1 1 1 1 1 1 1 1 1 1 7 7 7 1 
two
1 1 1 1 1 1 1 1 0 0 0 0 0 0 0 0 0 0 0 0 0 
1 1 1 0 0 0 0 1 0 0 0 0 0 0 0 0 0 0 0 0 0 
1 1 0 0 0 0 0 1 0 0 0 0 0 5 0 0 0 0 0 0 0 
1 0 0 0 0 0 4 1 0 0 0 0 0 6 0 0 1 1 1 0 0 
0 0 0 0 0 0 1 1 0 * 0 0 1 1 1 0 1 0 0 0 0 
0 0 0 0 0 0 0 1 1 1 1 0 0 1 0 0 1 0 0 0 0 
5 6 0 0 9 0 0 0 0 1 0 0 0 0 0 0 1 1 1 1 3 
6 5 3 0 1 1 1 1 1 1 0 0 0 0 0 0 1 0 0 0 3 
1 1 3 0 0 0 0 0 0 1 7 7 7 7 7 7 1 0 0 0 3 
0 0 3 0 0 0 0 0 0 1 1 1 1 1 1 1 1 0 0 0 3 
5 0 3 0 5 0 0 0 0 0 0 0 0 0 0 0 0 0 0 0 3 
0 0 3 0 0 0 0 0 0 0 0 0 0 0 0 0 0 0 0 0 3 
0 0 3 0 0 0 0 0 0 0 0 0 0 0 0 0 4 0 0 0 3 
1 1 1 1 1 0 0 0 0 0 0 0 0 0 0 0 0 0 0 0 3 
8 0 2 2 0 0 0 1 0 9 0 0 1 0 0 0 0 0 0 0 3 
1 1 1 1 1 1 1 1 1 1 1 1 1 1 1 1 1 1 1 1 1 
three
8 0 0 0 0 2 2 0 0 0 6 5 0 0 0 0 0 0 0 0 0 
1 1 1 1 1 1 1 1 0 0 5 6 0 0 0 0 0 0 0 0 0 
4 0 0 0 0 0 0 0 1 1 0 0 0 0 0 0 0 0 0 6 5 
0 0 0 0 3 0 9 1 9 0 0 0 0 0 0 0 0 0 0 0 0 
0 1 1 1 3 1 1 0 1 1 1 1 1 1 0 0 0 0 9 0 0 
0 0 0 0 3 0 0 0 0 0 0 4 0 1 4 0 1 1 1 1 1 
0 0 0 0 3 0 0 0 0 0 0 0 0 1 4 2 2 0 0 0 0 
5 0 0 0 3 0 0 0 0 0 0 0 0 0 1 1 1 1 0 0 0 
6 1 0 0 3 0 1 1 1 1 1 0 0 0 0 0 0 0 1 0 * 
5 1 3 0 1 1 0 0 0 0 0 0 0 6 0 0 0 0 0 0 1 
6 1 3 1 0 0 0 0 0 0 0 0 5 0 5 0 0 0 0 0 1 
5 1 3 1 0 0 0 0 0 0 0 0 0 0 0 0 0 0 0 3 1 
6 1 3 0 1 1 0 0 0 0 0 0 0 0 0 0 1 0 0 3 1 
0 1 3 0 2 0 0 0 0 0 0 0 1 0 0 1 0 0 0 3 1 
0 0 3 0 1 1 1 0 0 0 0 0 0 0 0 0 0 4 0 3 1 
1 1 1 1 1 1 1 1 1 1 7 7 7 7 7 7 1 1 1 1 1 